111111111111111111111
100000000000E00000001
10000C000000000000001
100000000000000000001
1000000000000000000P1
111111111111111111111
