111111111111111111111
100000000000E00000001
10000C000000000000001
100000000000000000001
100000000P00000000001
111111111111111111111
