111111111111111111111
100000000000000000001
100000000000000000001
100000000000000000001
1000000000000000000S1
111111111111111111111
