111111111111111111111
100000000000E00000001
100000C00000000000001
100000000C00000000001
1000000000000000000P1
111111111111111111111
